package editor_config // import "."


TYPES

type AssetType = string

const (
	AssetTypeH              AssetType = "h"
	AssetTypeC              AssetType = "c"
	AssetTypeGo             AssetType = "go"
	AssetTypeMap            AssetType = "map"
	AssetTypeObj            AssetType = "obj"
	AssetTypeGlb            AssetType = "glb"
	AssetTypeGltf           AssetType = "gltf"
	AssetTypeImage          AssetType = "image"
	AssetTypeMesh           AssetType = "mesh"
	AssetTypeStage          AssetType = "stg"
	AssetTypeHTML           AssetType = "html"
	AssetTypeShaderPipeline AssetType = "shaderpipeline"
)
type FileExtension = string

const (
	FileExtensionH              FileExtension = ".h"
	FileExtensionC              FileExtension = ".c"
	FileExtensionGo             FileExtension = ".go"
	FileExtensionMap            FileExtension = ".map"
	FileExtensionObj            FileExtension = ".obj"
	FileExtensionGlb            FileExtension = ".glb"
	FileExtensionGltf           FileExtension = ".gltf"
	FileExtensionPng            FileExtension = ".png"
	FileExtensionMesh           FileExtension = ".msh"
	FileExtensionStage          FileExtension = ".stg"
	FileExtensionHTML           FileExtension = ".html"
	FileExtensionShaderPipeline FileExtension = ".shaderpipeline"
	FileExtensionAssetDbInfo    FileExtension = ".adi"
)
